15 15 50
0 0 D 0 2 0 D 0 D 0 2 0 D 0 0
0 D 0 0 0 0 0 0 0 0 0 0 0 D 0
0 0 0 0 0 0 0 0 0 0 0 0 0 0 0
1 S 0 0 D 0 0 D 0 0 D 0 0 S 1
D 0 0 4 0 D 0 0 0 D 0 4 0 0 D
2 0 2 D 3 0 D 0 D 0 3 D 2 0 2
0 0 0 0 0 0 0 0 0 0 0 0 0 0 0
0 0 0 D D D 0 0 0 D D D 0 0 0
2 D 5 0 0 0 0 0 0 0 0 0 5 D 2
3 0 D 0 0 0 0 D 0 0 0 0 D 0 3
D D D 0 4 0 0 0 0 0 4 0 D D D
0 0 2 0 D 0 0 0 0 0 D 0 2 0 0
5 D 0 0 1 0 4 0 4 0 1 0 0 D 5
0 0 0 0 0 0 D 0 D 0 0 0 0 0 0
4 2 D D 4 0 0 0 0 0 4 D D 2 4
