15 15 60
5 0 0 3 0 0 1 0 D 0 D 0 0 0 5
D 1 0 D 0 D D 0 0 0 0 D D 0 0
0 0 0 0 0 0 1 0 0 0 0 0 0 0 0
0 0 2 D 0 0 0 1 D 0 S 0 0 0 3
D D D 0 0 0 0 4 0 0 0 0 0 D 3
D 0 4 2 D D 0 0 D 3 0 0 0 0 0
3 2 D 0 0 0 D 1 0 0 0 0 D 4 D
0 D 0 0 0 D 0 0 D 0 D 1 D 3 D
3 2 D 0 0 0 D 1 0 0 0 0 D 4 D
D 0 4 2 D D 0 0 D 3 0 0 0 0 0
D D D 0 0 0 0 4 0 0 0 0 0 D 3
0 0 2 D 0 0 0 1 D 0 S 0 0 0 3
0 0 0 0 0 0 1 0 0 0 0 0 0 0 0
D 1 0 D 0 D D 0 0 0 0 D D 0 0
5 0 0 3 0 0 1 0 D 0 D 0 0 0 5
