15 15 20
0 3 0 1 D 3 0 0 0 3 D 0 0 0 4
3 0 0 D 3 0 0 0 0 0 0 0 0 0 3
0 0 0 0 D 0 0 0 D 0 0 D 1 D D
1 D 0 0 0 0 0 D 0 0 0 0 0 0 0
D 3 D 0 D D 2 D 0 0 D 5 0 D 4
3 0 0 0 D D 0 0 S 0 3 0 0 0 0
0 0 0 0 2 0 0 D 0 0 D 0 0 0 D
0 0 0 D D 0 D 0 0 0 0 0 0 D D
0 0 D 0 0 S 0 0 D 0 D 2 0 0 D
3 0 0 0 0 0 0 0 0 0 2 0 0 0 3
D 0 0 0 D 3 D 0 D 2 D 0 0 0 5
0 0 D 0 5 0 0 0 2 0 0 2 D 2 D
0 0 1 0 0 0 0 0 0 0 0 D 0 0 D
0 0 D 0 D 0 0 D 0 0 0 2 0 0 0
4 3 D 0 4 0 D D D 3 5 D D 0 0
