15 15 50
0 0 2 0 3 D 2 0 0 0 4 0 5 2 0
1 0 D 0 0 0 5 D D 0 0 0 D 0 2
1 0 2 D 0 D 0 1 0 0 D 0 0 D 5
0 2 0 0 D 0 0 D 4 0 0 D 0 0 0
D 0 0 0 0 0 0 0 0 D 0 0 D 0 4
D 0 0 D 1 0 0 0 0 0 D 0 0 0 0
D 0 0 1 0 0 0 0 0 0 0 4 0 D 0
2 1 D D S 0 D 0 0 0 0 D 1 D 0
D 1 0 D 0 0 2 D 0 0 0 0 0 5 2
0 0 0 0 0 D 0 0 0 0 0 0 D 0 D
0 0 2 0 D 0 0 S 0 1 0 D 0 0 3
D 2 D 0 0 0 D D 1 D 0 0 D 0 0
0 1 0 D 2 0 0 D 0 0 0 0 2 D 2
4 D 1 2 0 0 1 1 0 0 0 2 0 0 0
0 4 0 D 0 0 D 2 D D D 0 1 1 0
