15 15 50
3 0 0 0 0 D 0 0 0 D 0 0 0 0 3
5 4 0 D 2 1 D 0 D 1 2 D 0 4 5
0 0 0 0 0 0 2 0 2 0 0 0 0 0 0
0 D 0 0 D 0 5 0 5 0 D 0 0 D 0
4 2 D 0 1 0 3 D 3 0 1 0 D 2 4
D D 0 0 0 0 0 2 0 0 0 0 0 D D
0 0 0 0 0 0 0 0 0 0 0 0 0 0 0
0 D 0 0 0 1 0 0 0 1 0 0 0 D 0
0 D 0 0 0 D 0 0 0 D 0 0 0 D 0
1 0 0 0 D 0 0 0 0 0 D 0 0 0 1
0 0 0 0 5 D D D D D 5 0 0 0 0
0 D 0 D 3 0 2 4 2 0 3 D 0 D 0
0 S D 3 0 0 D D D 0 0 3 D S 0
0 0 0 0 0 0 0 0 0 0 0 0 0 0 0
D 0 0 0 0 0 0 0 0 0 0 0 0 0 D
