15 15 50
D D D D D D D D D D D D D D D
D 1 0 3 D 0 1 0 D 0 3 0 0 3 D
D 0 0 0 0 0 D 0 D 0 1 1 0 3 D
D 3 0 D 0 2 0 3 D 0 2 0 0 0 D
D D 0 0 1 2 D 5 D 3 S 0 0 2 D
D 0 0 2 2 0 1 D D 0 0 0 0 0 D
D 1 D 0 D 1 1 0 D 0 0 1 1 0 D
D 0 0 3 5 D 0 0 0 0 0 0 0 0 D
D D D D D D D 0 D D D 1 D D D
D 0 0 0 3 0 0 0 D 3 0 0 D D D
D 3 1 2 S 0 0 0 D 0 D 2 D 4 D
D 0 1 0 0 0 1 0 1 0 2 0 0 3 D
D 0 0 0 0 0 1 0 D D D 0 0 D D
D 3 3 0 2 0 0 0 D D 4 3 D D D
D D D D D D D D D D D D D D D
