15 15 50
D D D D D D D D D D D D D D D
D 0 2 0 0 0 2 0 0 3 0 2 3 5 D
D 2 D D D D 0 D 2 D D D D 2 D
D 0 D 2 0 D 0 D 1 D 1 0 D 0 D
D 0 D 0 0 0 1 D 0 0 2 0 D 0 D
D 0 D D 0 0 1 D 2 S 0 D D 2 D
D 2 0 0 1 1 0 0 0 3 0 0 0 0 D
D 0 D D D D 0 0 0 D D D D 0 D
D 0 2 1 0 2 0 0 0 0 0 2 0 3 D
D 3 D D 0 S 3 D 0 0 1 D D 0 D
D 0 D 1 2 0 0 D 0 1 2 2 D 5 D
D 2 D 0 0 D 0 D 2 D 2 0 D 0 D
D 3 D D D D 0 D 0 D D D D 0 D
D 5 2 0 0 2 0 0 3 0 5 0 0 2 D
D D D D D D D D D D D D D D D
