15 15 50
1 0 D 1 2 0 4 0 4 0 2 1 D 0 1
0 0 D 0 0 0 D 0 D 0 0 0 D 0 0
0 2 2 0 0 0 1 D 1 0 0 0 2 2 0
0 0 D 0 1 0 2 0 2 0 1 0 D 0 0
1 D 4 0 0 0 0 0 0 0 0 0 4 D 1
0 0 0 0 0 D 2 0 2 D 0 0 0 0 0
0 0 D 2 0 0 D 0 D 0 0 2 D 0 0
D 0 0 0 2 D 0 0 0 D 2 0 0 0 D
D 0 D 4 0 5 0 2 0 5 0 4 D 0 D
0 0 0 0 0 D D 0 D D 0 0 0 0 0
D 0 D 0 0 0 1 0 1 0 0 0 D 0 D
0 0 D 0 1 0 2 D 2 0 1 0 D 0 0
0 D 3 0 0 0 0 0 0 0 0 0 3 D 0
0 D D 1 2 0 0 0 0 0 2 1 D D 0
3 D 0 S 0 0 0 0 0 0 0 S 0 D 3
