15 15 50
0 2 0 0 D 0 0 0 2 D 0 3 0 D 2
D 0 0 0 3 0 0 0 1 0 5 2 0 0 1
0 0 0 0 0 0 0 D D 0 0 0 4 2 D
D 1 0 0 0 0 D D 0 2 0 0 0 0 D
0 1 0 0 D D D 5 0 D S D 4 0 0
3 0 0 0 0 0 0 0 0 4 0 0 0 2 0
D 0 0 D 0 D 0 0 0 0 0 0 0 0 1
D 0 0 D 0 0 0 0 0 0 0 0 D 0 D
D 0 0 D 0 D 0 0 0 0 0 0 0 0 1
3 0 0 0 0 0 0 0 0 4 0 0 0 2 0
0 1 0 0 D D D 5 0 D S D 4 0 0
D 1 0 0 0 0 D D 0 2 0 0 0 0 D
0 0 0 0 0 0 0 D D 0 0 0 4 2 D
D 0 0 0 3 0 0 0 1 0 5 2 0 0 1
0 2 0 0 D 0 0 0 2 D 0 3 0 D 2
