15 15 50
0 0 0 D 2 5 1 0 1 5 2 D 0 0 0
0 0 0 0 0 0 0 0 0 0 0 0 0 0 0
D 2 0 D 1 D 3 4 3 D 1 D 0 2 D
3 0 5 0 0 0 D 0 D 0 0 0 5 0 3
D 0 D 0 D 0 0 0 0 0 D 0 D 0 D
D 0 0 0 3 2 0 0 0 2 3 0 0 0 D
D 0 0 0 0 0 0 0 0 0 0 0 0 0 D
0 2 0 0 4 0 0 0 0 0 4 0 0 2 0
0 0 0 0 0 0 0 0 0 0 0 0 0 0 0
3 3 0 0 1 D 1 2 1 D 1 0 0 3 3
0 0 0 D 0 0 0 0 0 0 0 D 0 0 0
0 0 1 0 D D 0 0 0 D D 0 1 0 0
0 0 0 0 1 D 0 0 0 D 1 0 0 0 0
S 0 1 D 0 0 0 0 0 0 0 D 1 0 S
3 D D D 0 D D 0 D D 0 D D D 3
