15 15 50
D D D 0 0 0 1 0 2 0 0 3 D D D
D 3 0 0 3 0 D D D 0 5 2 0 0 D
D 0 0 0 0 0 0 D 0 0 0 0 4 2 D
0 1 0 0 0 0 0 D 0 2 0 0 0 0 0
3 1 0 0 0 1 0 5 0 0 0 0 4 0 0
0 D 0 D 2 D 0 D 0 D 0 D 0 D 0
0 D 0 D 0 D 0 D 0 D 0 D 0 D 0
S 0 D 0 0 5 D 0 3 D 4 D 0 D S
0 D 0 D 0 D 0 D 0 D 0 D 0 D 0
0 D 0 D 2 D 0 D 0 D 0 D 0 D 0
3 1 0 0 0 1 0 5 0 0 0 0 4 0 0
0 1 0 0 0 0 0 D 0 2 0 0 0 0 0
D 0 0 0 0 0 0 D 0 0 0 0 4 2 D
D 3 0 0 3 0 D D D 0 5 2 0 0 D
D D D 0 0 0 1 0 2 0 0 3 D D D
