15 15 50
4 3 0 4 0 D 0 3 0 0 0 D 0 0 1
3 0 0 3 D 5 2 D 0 0 D D 0 0 1
0 0 0 0 0 0 0 0 D 5 D 1 0 0 0
4 3 0 0 0 0 0 0 0 2 0 D D 0 0
0 D 0 0 D 0 1 0 0 D 5 D 0 0 3
D 5 0 0 0 D 0 0 4 D 0 0 0 D D
0 2 0 0 1 0 0 D 0 0 0 0 0 0 0
3 D 0 0 0 0 D 0 0 0 0 D D 0 0
0 0 D 0 0 4 0 0 0 D 0 0 1 0 1
0 0 5 2 D D 0 0 D 0 0 0 0 0 S
0 D D 0 5 0 0 0 0 0 0 0 0 0 D
D D 1 D D 0 0 D 0 0 0 0 0 0 1
0 0 0 D 0 0 0 D 1 0 0 0 0 0 2
0 0 0 0 0 D 0 0 0 0 0 0 0 0 0
1 1 0 0 3 D 0 0 1 S D 1 2 0 0
