15 15 50
0 1 0 D 0 1 4 D D D 2 0 0 D D
0 0 5 0 1 0 0 D D 0 0 0 0 0 0
0 0 0 0 0 D 4 0 D 2 5 3 D 0 0
1 0 0 0 D 0 0 0 0 0 D 0 D 0 0
0 0 0 0 0 0 0 0 0 D 0 0 D 5 2
2 0 0 0 4 D 0 0 1 D 0 D 4 0 0
D 2 0 0 S 0 0 0 0 0 0 0 0 0 D
2 0 0 0 0 0 0 0 0 0 0 0 0 0 0
D 2 0 0 S 0 0 0 0 0 0 0 0 0 D
2 0 0 0 4 D 0 0 1 D 0 D 4 0 0
0 0 0 0 0 0 0 0 0 D 0 0 D 5 2
1 0 0 0 D 0 0 0 0 0 D 0 D 0 0
0 0 0 0 0 D 4 0 D 2 5 3 D 0 0
0 0 5 0 1 0 0 D D 0 0 0 0 0 0
0 1 0 D 0 1 4 D D D 2 0 0 D D
