15 15 50
D D D 0 0 0 5 S 0 0 0 0 D D D
D 0 2 0 0 D D D D D 0 1 3 2 D
D 2 0 0 0 0 0 D 0 0 0 0 4 2 D
0 0 0 0 0 0 0 D 0 2 0 0 2 0 0
0 0 0 0 0 1 0 0 0 0 0 1 0 0 0
0 D 0 D 2 D 0 D 0 D 1 D 0 D 0
0 D 0 D 0 D 0 D 0 D 0 D 0 D 0
5 5 D 5 5 5 D 0 0 D 5 D 5 D 5
0 D 0 D 0 D 0 D 0 D 0 D 0 D 0
0 D 0 D 2 D 0 D 0 D 1 D 0 D 0
0 0 0 0 0 1 0 0 0 0 0 1 0 0 0
0 0 0 0 0 0 0 D 0 2 0 0 2 0 0
D 2 0 0 0 0 0 D 0 0 0 0 4 2 D
D 0 2 0 0 D D D D D 0 1 3 2 D
D D D 0 0 0 5 S 0 0 0 0 D D D
