15 15 50
D D 0 1 0 1 D 0 D 1 0 1 0 D D
0 0 0 D 0 1 0 0 0 1 0 D 0 0 0
0 D 0 0 0 0 0 0 0 0 0 0 0 D 0
D 0 1 0 D 0 3 0 3 0 D 0 1 0 D
S 3 D 0 0 0 0 D 0 0 0 0 D 3 S
0 0 0 2 0 2 0 0 0 2 0 2 0 0 0
1 D 1 D 0 0 3 0 3 0 0 D 1 D 1
D 1 0 0 0 0 0 0 0 0 0 0 0 1 D
0 0 3 0 3 1 0 0 0 1 3 0 3 0 0
D 1 0 D D 4 D 0 D 4 D D 0 1 D
0 D D 0 4 0 1 0 1 0 4 0 D D 0
0 0 1 0 D 0 0 0 0 0 D 0 1 0 0
3 D 0 0 0 4 0 D 0 4 0 0 0 D 3
0 D 0 0 0 0 D 0 D 0 0 0 0 D 0
D 5 0 0 0 0 0 0 0 0 0 0 0 5 D
