15 15 50
D D D D D D D D D D D D D D D
D D 1 1 3 1 D 0 0 0 0 1 0 0 D
D 1 D 0 1 0 0 D D 0 0 0 1 0 D
D 1 0 D 0 0 0 0 D S 1 1 1 0 D
D 3 1 0 0 2 3 3 0 D 0 2 2 2 D
D 1 0 0 2 D 2 1 2 D 4 0 0 1 D
D D 0 0 3 2 D 0 1 D D D 0 0 D
D 0 D 0 3 1 0 0 1 0 0 D 0 0 D
D 0 D D 0 2 1 1 D 1 0 0 3 1 D
D 0 0 S D D D 0 1 D 1 0 0 0 D
D 0 0 1 0 4 D 0 0 1 D 0 3 1 D
D 1 0 1 2 0 D D 0 0 0 D D 2 D
D 0 1 1 2 0 0 0 3 0 3 D D 0 D
D 0 0 0 2 1 0 0 1 0 1 2 0 0 D
D D D D D D D D D D D D D D D
