15 15 50
4 0 0 0 1 0 D 0 5 0 2 3 0 0 0
1 1 D D 0 0 D 0 0 0 0 0 0 0 0
0 0 0 0 0 0 0 0 4 0 1 0 0 0 0
0 0 2 0 0 0 0 0 0 0 0 2 0 2 0
0 0 D 0 0 D 0 0 D S D 0 0 D 0
0 2 0 0 2 2 3 0 0 0 1 0 0 4 0
0 0 0 0 D 0 0 0 D 2 0 0 0 2 D
0 0 0 0 2 0 3 0 1 0 1 0 0 0 1
0 0 0 0 D 0 0 0 D 2 0 0 0 2 D
0 2 0 0 2 2 3 0 0 0 1 0 0 4 0
0 0 D 0 0 D 0 0 D S D 0 0 D 0
0 0 2 0 0 0 0 0 0 0 0 2 0 2 0
0 0 0 0 0 0 0 0 4 0 1 0 0 0 0
1 1 D D 0 0 D 0 0 0 0 0 0 0 0
4 0 0 0 1 0 D 0 5 0 2 3 0 0 0
