15 15 50
0 D 0 0 0 0 0 0 D 0 0 4 0 0 0
0 0 0 0 5 0 0 0 0 0 0 0 D D 0
5 0 3 5 0 0 0 0 0 0 D D 0 0 0
5 0 0 5 0 0 0 0 0 0 0 0 0 0 0
0 0 0 S 0 0 0 4 0 4 0 0 0 D 0
0 1 D 5 0 0 0 0 0 D 0 0 0 0 0
0 0 0 0 0 0 0 0 D 0 0 0 0 0 0
0 0 3 0 D 0 0 0 0 0 0 5 0 0 0
0 0 0 0 0 0 0 0 D 0 0 0 0 0 0
0 1 D 5 0 0 0 0 0 D 0 0 0 0 0
0 0 0 S 0 0 0 4 0 4 0 0 0 D 0
5 0 0 5 0 0 0 0 0 0 0 0 0 0 0
5 0 3 5 0 0 0 0 0 0 D D 0 0 0
0 0 0 0 5 0 0 0 0 0 0 0 D D 0
0 D 0 0 0 0 0 0 D 0 0 4 0 0 0
