15 15 50
4 0 0 0 0 D 0 D 0 D 0 0 0 0 4
3 0 1 0 0 1 0 3 0 1 0 0 1 0 3
D D 0 0 D D D 0 D D D 0 0 D D
1 0 2 0 0 0 1 0 1 0 0 0 2 0 1
0 0 0 0 0 D 2 1 2 D 0 0 0 0 0
D 0 1 D D D D 1 D D D D 1 0 D
0 2 0 1 0 0 0 2 0 0 0 1 0 2 0
2 D D 0 0 1 D 0 D 1 0 0 D D 2
D D 0 0 0 0 2 0 2 0 0 0 0 D D
D 0 D 0 S 0 1 0 1 0 S 0 D 0 D
4 0 0 D 0 0 D 0 D 0 0 D 0 0 4
3 1 0 0 3 0 2 0 2 0 3 0 0 1 3
0 0 0 D D 0 0 2 0 0 D D 0 0 0
D 0 D D 3 D 2 0 2 D 3 D D 0 D
0 0 1 D 0 0 1 1 1 0 0 D 1 0 0
