15 15 50
2 1 0 D 1 D 1 D 1 D 1 D 0 1 2
1 0 D 0 0 1 2 2 2 1 0 0 D 0 1
1 0 2 D 0 0 1 2 1 0 0 D 2 0 1
1 S 0 0 0 0 0 D 0 0 0 0 0 S 1
2 0 1 D 0 0 D D D 0 0 D 1 0 2
0 0 0 0 D 1 0 0 0 1 D 0 0 0 0
3 1 0 0 D 0 1 0 1 0 D 0 0 1 3
D 2 0 D 0 0 3 0 3 0 0 D 0 2 D
0 0 0 D 0 1 0 0 0 1 0 D 0 0 0
0 1 1 0 D 0 0 0 0 0 D 0 1 1 0
0 0 0 0 D D 0 D 0 D D 0 0 0 0
D 0 1 1 1 2 0 D 0 2 1 1 1 0 D
D 0 0 0 0 4 1 D 1 4 0 0 0 0 D
0 3 0 D 1 1 1 0 1 1 1 D 0 3 0
0 0 1 0 D D D 0 D D D 0 1 0 0
