15 15 50
0 0 0 0 5 2 0 0 0 2 5 0 0 0 0
0 0 0 0 0 0 0 0 0 0 0 0 0 0 0
0 0 0 0 0 0 D 2 D 0 0 0 0 0 0
0 5 0 0 0 0 5 0 5 0 0 0 0 5 0
D 0 0 0 0 0 0 0 0 0 0 0 0 0 D
D 4 0 5 0 0 0 0 0 0 0 5 0 4 D
4 0 0 0 0 0 0 0 0 0 0 0 0 0 4
0 0 D 5 0 0 0 0 0 0 0 5 D 0 0
0 D 0 D 0 0 0 5 0 0 0 D 0 D 0
0 D S 0 D D 3 D 3 D D 0 S D 0
D 0 0 0 0 0 0 1 0 0 0 0 0 0 D
0 0 D 0 0 0 D 0 D 0 0 0 D 0 0
D 0 0 0 5 0 0 0 0 0 5 0 0 0 D
D 0 0 0 0 0 0 0 0 0 0 0 0 0 D
0 0 0 0 0 3 0 0 0 3 0 0 0 0 0
