15 15 50
3 0 3 0 0 D 0 0 0 0 0 0 D 0 D
0 D D 1 0 0 0 0 2 0 S 4 D 0 D
D 0 D 1 D 3 D 4 0 0 0 0 2 0 1
D 0 1 D 0 0 0 D 0 1 D D 2 D 0
D 0 2 2 3 0 0 1 D 0 0 D 0 D 0
D 0 0 2 0 1 0 D 0 2 0 D 1 0 0
0 0 2 0 1 D 0 0 0 1 0 2 1 0 D
0 0 0 D 0 0 0 0 0 0 D 1 1 0 0
0 0 2 0 1 D 0 0 0 1 0 2 1 0 D
D 0 0 2 0 1 0 D 0 2 0 D 1 0 0
D 0 2 2 3 0 0 1 D 0 0 D 0 D 0
D 0 1 D 0 0 0 D 0 1 D D 2 D 0
D 0 D 1 D 3 D 4 0 0 0 0 2 0 1
0 D D 1 0 0 0 0 2 0 S 4 D 0 D
3 0 3 0 0 D 0 0 0 0 0 0 D 0 D
