15 15 50
0 0 0 D D D D 0 D D D D 0 0 0
0 0 0 5 3 0 5 0 5 0 3 5 0 0 0
0 0 5 D D 4 0 0 0 4 D D 5 0 0
0 0 4 0 0 D 4 0 4 D 0 0 4 0 0
0 0 0 0 0 3 0 0 0 3 0 0 0 0 0
0 0 0 0 0 0 0 0 0 0 0 0 0 0 0
0 0 0 0 0 D 0 0 0 D 0 0 0 0 0
0 0 0 0 0 0 0 0 0 0 0 0 0 0 0
0 0 0 0 0 D 0 0 0 D 0 0 0 0 0
0 0 D 0 D 0 D 0 D 0 D 0 D 0 0
0 0 D 0 0 5 4 0 4 5 0 0 D 0 0
0 0 0 0 0 0 0 0 0 0 0 0 0 0 0
0 0 0 D 0 0 0 0 0 0 0 D 0 0 0
0 D 3 D D 0 0 0 0 0 D D 3 D 0
0 0 0 D 5 S 0 D 0 S 5 D 0 0 0
