15 15 50
0 0 0 0 0 0 0 2 0 1 D 0 D 0 0
0 0 0 D 0 1 2 0 1 3 0 0 0 0 0
0 3 0 1 0 0 0 0 2 0 4 1 3 0 0
2 0 4 0 0 0 0 0 0 0 0 0 2 0 0
0 D 2 0 0 0 0 2 2 0 0 0 1 0 D
0 0 0 0 0 0 0 D 0 5 D S 0 0 0
0 1 0 0 0 0 0 0 0 0 0 1 0 0 0
0 3 3 D 0 0 D 0 0 0 2 0 0 0 D
0 1 0 0 0 0 0 0 0 0 0 1 0 0 0
0 0 0 0 0 0 0 D 0 5 D S 0 0 0
0 D 2 0 0 0 0 2 2 0 0 0 1 0 D
2 0 4 0 0 0 0 0 0 0 0 0 2 0 0
0 3 0 1 0 0 0 0 2 0 4 1 3 0 0
0 0 0 D 0 1 2 0 1 3 0 0 0 0 0
0 0 0 0 0 0 0 2 0 1 D 0 D 0 0
