15 15 50
0 0 2 0 0 0 0 0 0 0 0 0 2 0 0
D 1 0 0 D 0 D 0 D 0 D 0 0 1 D
0 D D 0 0 D D 0 D D 0 0 D D 0
0 0 2 0 0 0 5 D 5 0 0 0 2 0 0
0 0 0 0 D 0 D D D 0 D 0 0 0 0
0 0 D 0 4 D 2 4 2 D 4 0 D 0 0
0 0 0 2 0 0 0 D 0 0 0 2 0 0 0
0 0 2 0 0 0 2 0 2 0 0 0 2 0 0
D 0 4 0 D 0 2 0 2 0 D 0 4 0 D
0 0 D 2 0 0 0 1 0 0 0 2 D 0 0
D D 0 0 0 0 3 0 3 0 0 0 0 D D
3 0 5 0 D D 0 1 0 D D 0 5 0 3
0 D 0 0 0 0 S 2 S 0 0 0 0 D 0
0 D D D 0 0 D 0 D 0 0 D D D 0
4 0 1 D 0 0 D 0 D 0 0 D 1 0 4
