15 15 50
0 0 0 1 0 2 0 D 0 2 0 1 0 0 0
0 0 0 0 0 2 D 0 D 2 0 0 0 0 0
D 0 0 0 D D 5 0 5 D D 0 0 0 D
0 0 2 D 0 0 0 0 0 0 0 D 2 0 0
0 0 2 0 2 0 0 0 0 0 2 0 2 0 0
1 4 0 D 1 D D 0 D D 1 D 0 4 1
D 0 2 3 2 D 0 D 0 D 2 3 2 0 D
D 0 3 0 0 0 3 0 3 0 0 0 3 0 D
0 D 0 2 0 D 0 2 0 D 0 2 0 D 0
0 0 S 0 0 0 1 0 1 0 0 0 S 0 0
4 0 1 0 0 0 0 D 0 0 0 0 1 0 4
0 0 1 1 0 1 0 0 0 1 0 1 1 0 0
0 0 1 0 0 0 D 0 D 0 0 0 1 0 0
D 0 1 0 0 0 0 0 0 0 0 0 1 0 D
0 0 0 D 0 0 1 0 1 0 0 D 0 0 0
