15 15 50
0 0 D D 0 D 0 0 0 D 0 D D 0 0
0 D D 0 0 0 0 5 0 0 0 0 D D 0
0 0 D D D 5 D 2 D 5 D D D 0 0
0 D D D D 0 0 0 0 0 D D D D 0
0 D 0 2 3 D 0 0 0 D 3 2 0 D 0
0 0 0 0 0 0 5 D 5 0 0 0 0 0 0
0 0 D 0 0 4 3 0 3 4 0 0 D 0 0
D 3 0 0 D D 2 0 2 D D 0 0 3 D
0 0 0 0 0 D 1 D 1 D 0 0 0 0 0
0 0 D 4 0 D 0 4 0 D 0 4 D 0 0
D D 0 0 0 D 2 D 2 D 0 0 0 D D
0 2 0 0 D 0 2 0 2 0 D 0 0 2 0
0 0 0 D 0 D 0 D 0 D 0 D 0 0 0
D 0 0 D 0 D 0 D 0 D 0 D 0 0 D
0 3 D 0 S 0 3 1 3 0 S 0 D 3 0
