15 15 50
0 4 0 0 0 5 0 0 0 0 0 D D 5 0
0 D 0 5 0 0 0 0 0 0 0 0 D 0 D
5 0 D 0 0 D 0 D 0 S 0 0 0 2 D
0 0 D 5 D 0 0 0 D 0 D D 0 0 0
0 0 0 0 D D D 0 0 0 0 0 0 0 D
0 D 0 3 0 0 D 0 0 0 D 0 D 0 4
0 0 0 0 0 D D D 0 D 0 0 D 5 0
0 D 0 1 3 0 D 0 0 5 5 0 0 0 0
0 0 0 0 0 D D D 0 D 0 0 D 5 0
0 D 0 3 0 0 D 0 0 0 D 0 D 0 4
0 0 0 0 D D D 0 0 0 0 0 0 0 D
0 0 D 5 D 0 0 0 D 0 D D 0 0 0
5 0 D 0 0 D 0 D 0 S 0 0 0 2 D
0 D 0 5 0 0 0 0 0 0 0 0 D 0 D
0 4 0 0 0 5 0 0 0 0 0 D D 5 0
