15 15 50
0 0 0 0 0 0 0 0 0 0 0 0 0 0 0
0 D D 0 1 D 2 0 2 D 1 0 D D 0
1 D 0 0 0 0 1 0 1 0 0 0 0 D 1
D D 0 1 1 0 0 0 0 0 1 1 0 D D
0 1 0 0 1 0 0 0 0 0 1 0 0 1 0
D 0 0 1 1 0 D D D 0 1 1 0 0 D
0 0 2 S 0 D 1 0 1 D 0 S 2 0 0
0 0 1 1 0 0 0 0 0 0 0 1 1 0 0
0 0 0 0 0 0 1 0 1 0 0 0 0 0 0
0 0 1 D 0 0 0 3 0 0 0 D 1 0 0
1 0 1 0 0 2 D 0 D 2 0 0 1 0 1
0 0 1 0 1 2 0 0 0 2 1 0 1 0 0
1 0 4 3 0 0 1 1 1 0 0 3 4 0 1
0 0 1 0 1 3 3 0 3 3 1 0 1 0 0
0 2 0 2 0 1 0 0 0 1 0 2 0 2 0
