15 15 50
0 0 0 0 0 0 0 5 0 0 0 0 0 0 0
0 D 0 0 0 0 0 D 0 0 0 0 0 D 0
0 D D D 0 D 0 5 0 D 0 D D D 0
0 4 0 0 0 0 0 2 0 0 0 0 0 4 0
0 0 0 0 0 5 0 0 0 5 0 0 0 0 0
0 0 0 4 0 3 D 0 D 3 0 4 0 0 0
0 0 0 0 0 0 0 0 0 0 0 0 0 0 0
0 0 D 0 0 0 0 0 0 0 0 0 D 0 0
0 0 0 0 0 0 0 0 0 0 0 0 0 0 0
0 0 0 0 0 D 5 0 5 D 0 0 0 0 0
4 D 0 0 S 0 0 D 0 0 S 0 0 D 4
D 0 0 0 0 3 0 0 0 3 0 0 0 0 D
0 4 0 0 D 3 4 0 4 3 D 0 0 4 0
0 0 0 0 4 0 0 2 0 0 4 0 0 0 0
0 0 D 0 0 0 D 0 D 0 0 0 D 0 0
