15 15 50
3 0 4 0 0 0 2 1 0 0 0 0 0 0 0
0 3 0 0 4 0 D 0 0 0 0 5 0 0 0
D 0 0 0 0 0 D 0 D 0 0 0 0 0 0
0 4 0 D 0 D 0 0 0 0 0 0 0 3 0
0 0 4 0 0 0 D D 0 0 0 0 0 S 0
0 0 0 0 D 0 0 0 0 0 D 0 0 5 0
D 0 D 0 0 0 D 0 0 3 0 4 0 0 0
D 1 0 0 D 0 0 0 5 D D 0 4 0 0
D 0 D 0 0 0 D 0 0 3 0 4 0 0 0
0 0 0 0 D 0 0 0 0 0 D 0 0 5 0
0 0 4 0 0 0 D D 0 0 0 0 0 S 0
0 4 0 D 0 D 0 0 0 0 0 0 0 3 0
D 0 0 0 0 0 D 0 D 0 0 0 0 0 0
0 3 0 0 4 0 D 0 0 0 0 5 0 0 0
3 0 4 0 0 0 2 1 0 0 0 0 0 0 0
