15 15 50
4 2 0 0 0 0 D 0 D 0 0 0 0 2 4
2 0 0 0 0 0 0 0 0 0 0 0 0 0 2
0 0 0 0 D 0 0 0 0 0 D 0 0 0 0
0 0 0 4 D 0 0 D 0 0 D 4 0 0 0
1 3 D 0 0 D 0 0 0 D 0 0 D 3 1
D 0 0 0 0 D 0 0 0 D 0 0 0 0 D
0 0 0 D 0 0 D 4 D 0 0 D 0 0 0
D 0 0 0 0 0 0 0 0 0 0 0 0 0 D
0 D 0 D 0 5 2 0 2 5 0 D 0 D 0
2 S D 2 0 0 0 2 0 0 0 2 D S 2
1 0 4 D 0 4 D 0 D 4 0 D 4 0 1
0 0 2 D D 0 D 0 D 0 D D 2 0 0
0 0 0 0 0 0 0 0 0 0 0 0 0 0 0
0 D D 4 1 D 0 0 0 D 1 4 D D 0
0 0 4 D 0 0 0 0 0 0 0 D 4 0 0
