15 15 50
4 0 0 0 3 0 0 0 0 0 3 0 0 0 4
0 0 4 3 0 0 0 0 0 0 0 3 4 0 0
0 0 4 0 0 0 0 0 0 0 0 0 4 0 0
0 0 0 0 4 S D 0 D S 4 0 0 0 0
3 0 0 4 0 0 D 0 D 0 0 4 0 0 3
0 0 0 0 D 0 0 D 0 0 D 0 0 0 0
0 0 D 0 0 D 0 0 0 D 0 0 D 0 0
0 4 D 0 D 0 0 0 0 0 D 0 D 4 0
0 D 0 0 0 0 D 0 D 0 0 0 0 D 0
D D 0 0 0 0 D 0 D 0 0 0 0 D D
0 0 0 0 0 D 0 0 0 D 0 0 0 0 0
0 0 0 D 0 D 5 D 5 D 0 D 0 0 0
D 2 0 0 0 D 0 2 0 D 0 0 0 2 D
0 0 0 0 0 0 4 0 4 0 0 0 0 0 0
0 0 0 0 0 0 5 0 5 0 0 0 0 0 0
