15 15 50
0 0 0 0 D 0 D 1 D 0 D 0 0 0 0
0 0 0 5 0 0 4 0 4 0 0 5 0 0 0
0 0 0 0 0 0 0 0 0 0 0 0 0 0 0
5 D 0 2 D D 0 3 0 D D 2 0 D 5
D 0 0 0 D 0 0 0 0 0 D 0 0 0 D
D 0 4 0 D 0 0 D 0 0 D 0 4 0 D
0 5 0 0 D 0 0 D 0 0 D 0 0 5 0
4 5 0 0 D 0 2 0 2 0 D 0 0 5 4
D 0 0 0 0 0 0 0 0 0 0 0 0 0 D
4 0 0 0 0 S 0 D 0 S 0 0 0 0 4
0 D D 0 D 0 0 D 0 0 D 0 D D 0
0 0 0 0 0 D D 0 D D 0 0 0 0 0
0 0 D 0 D 0 0 0 0 0 D 0 D 0 0
0 0 D 0 0 4 D 0 D 4 0 0 D 0 0
4 0 D 0 0 0 0 D 0 0 0 0 D 0 4
