15 15 50
1 3 0 0 0 1 0 0 0 0 1 2 2 0 4
3 0 3 1 0 0 0 0 0 3 3 0 2 0 0
0 3 D 0 0 0 0 0 1 0 1 D D 2 0
0 1 0 1 1 0 0 1 0 0 0 0 1 0 0
0 0 0 1 0 S 0 0 1 0 0 0 0 0 0
1 0 0 0 S D D 0 0 0 0 1 0 0 2
0 0 0 0 0 D D 0 0 0 0 1 0 0 0
0 0 0 1 0 0 0 0 0 1 0 1 0 D 1
0 0 1 0 1 0 0 0 0 1 0 D D 4 0
0 3 0 0 0 0 0 1 1 0 0 0 D 0 0
1 3 1 0 0 0 0 0 0 0 0 0 1 0 D
2 0 D 0 0 1 1 1 D 0 0 2 0 1 0
2 2 D 1 0 0 0 0 D D 1 0 0 0 D
0 0 2 0 0 0 0 D 4 0 0 1 0 2 0
4 0 0 0 0 2 0 1 0 0 D 0 D 0 0
