13 13 50
2 0 3 1 4 0 0 2 0 0 0 1 3
0 D 5 0 0 0 0 D D D D 0 3
3 4 2 0 0 0 0 D 0 0 D 0 3
1 0 0 D D 0 0 0 0 D 0 1 2
4 0 0 D D 0 2 0 D 0 0 2 0
0 0 0 0 0 0 0 0 D 0 0 2 0
0 0 0 0 2 0 0 0 D 0 3 0 0
2 D D 0 0 0 0 2 D 0 1 0 0
0 D 0 0 D D D D 2 0 D D 1
0 D 0 D 0 0 0 0 0 0 1 S 0
0 D D 0 0 0 3 1 D 1 5 D 0
1 0 0 1 2 2 0 0 D S D 0 4
3 3 3 2 0 0 0 0 1 0 0 4 D
