11 11 50
S 3 3 3 D 0 0 0 0 0 0
3 3 D 0 1 0 1 2 0 0 2
3 D 1 0 0 1 0 0 0 0 0
3 0 0 0 0 0 0 0 0 D D
D 1 0 0 0 0 0 3 2 2 0
0 0 1 0 0 D 3 1 0 4 0
0 1 0 0 0 3 0 0 4 2 5
0 2 0 0 3 1 S 4 D 2 0
0 0 0 0 2 0 4 D D 2 0
0 0 0 D 2 4 2 2 2 0 D
0 2 0 D 0 0 5 0 0 D D
