11 11 50
0 3 2 0 1 3 3 0 1 0 3
3 D 0 0 2 0 3 1 0 0 0
2 0 3 S 0 0 0 1 0 2 0
0 0 S 0 0 0 0 3 0 3 3
1 2 0 0 D 0 0 3 0 0 D
3 0 0 0 0 0 2 0 0 D 1
3 3 0 0 0 2 0 0 0 0 3
0 1 1 3 3 0 0 0 0 0 0
1 0 0 0 0 0 0 0 D 0 D
0 0 2 3 0 D 0 0 0 5 3
3 0 0 3 D 1 3 0 D 3 D
