13 13 50
D 0 4 D 1 D 3 1 D S 2 4 1
0 1 0 2 0 2 0 2 1 0 0 0 D
4 0 D D D D D D D D D 3 1
D 2 D 0 0 3 2 0 0 0 D 0 0
1 0 D 0 0 1 0 0 1 1 D 1 0
D 2 D 3 1 0 0 D D 1 2 D 0
3 0 D 2 0 0 0 0 D 0 0 0 0
1 2 D 0 0 D 0 0 D 0 1 0 D
D 1 D 0 1 D D D D 0 1 1 0
S 0 D 0 1 1 0 0 0 1 1 0 3
2 0 D D D 2 0 1 1 1 0 0 1
4 0 3 0 1 D 0 0 1 0 0 0 2
1 D 1 0 0 0 0 D 0 3 1 2 D
