13 13 50
0 1 0 0 0 2 0 1 0 0 0 0 0
1 0 0 1 0 3 1 0 1 0 0 0 2
0 0 D 0 0 0 0 0 0 0 0 0 0
0 1 0 D D 1 0 0 4 0 0 0 0
0 0 0 D D 0 0 2 D 2 0 2 1
2 3 0 1 0 0 0 1 S 2 0 1 0
0 1 0 0 0 0 D 0 0 1 2 1 1
1 0 0 0 2 1 0 0 2 4 D 0 3
0 1 0 4 D S 0 2 D 2 D 2 0
0 0 0 0 2 2 1 4 2 0 0 0 0
0 0 0 0 0 0 2 D D 0 0 2 0
0 0 0 0 2 1 1 0 2 0 2 0 2
0 2 0 0 1 0 1 3 0 0 0 2 0
