15 15 50
2 3 3 0 0 0 0 0 0 0 0 1 0 0 0
3 0 0 0 0 0 0 0 0 0 0 0 0 1 0
3 0 2 0 D 0 1 0 0 0 0 0 0 0 0
0 0 0 0 D 0 0 0 0 0 D 0 1 1 2
0 0 D D D 0 0 0 0 0 0 1 0 0 0
0 0 0 0 0 0 0 D 0 0 0 0 0 3 4
0 0 1 0 0 0 0 0 0 1 0 1 2 2 0
0 0 0 0 0 D 0 0 0 0 0 0 0 0 0
0 0 0 0 0 0 0 0 0 0 0 1 1 0 0
0 0 0 0 0 0 1 0 0 D 0 0 2 0 2
0 0 0 D 0 0 0 0 0 0 0 0 1 3 4
1 0 0 0 1 0 1 0 1 0 0 0 S 0 1
0 0 0 1 0 0 2 0 1 2 1 S 0 D 5
0 1 0 1 0 3 2 0 0 0 3 0 D 0 1
0 0 0 2 0 4 0 0 0 2 4 1 5 1 0
