11 11 50
D D 1 1 0 2 0 0 0 0 0
D 0 0 S 0 0 0 1 1 0 D
1 0 0 0 0 0 3 0 0 0 1
1 S 0 D 0 2 4 5 3 3 0
0 0 0 0 D 5 0 0 3 0 1
2 0 0 2 5 2 2 0 0 1 1
0 0 3 4 0 2 D 4 D 4 0
0 1 0 5 0 0 4 0 0 1 0
0 1 0 3 3 0 D 0 D 0 D
0 0 0 3 0 1 4 1 0 D 0
0 D 1 0 1 1 0 0 D 0 0
