15 15 50
D 0 2 1 0 0 0 0 0 0 1 0 0 0 0
0 D 1 0 D D 3 D 0 0 4 2 0 1 0
2 1 D 2 0 2 0 0 4 3 0 0 0 1 0
1 0 2 5 0 0 3 0 1 D 0 0 0 D D
0 D 0 0 1 2 0 0 0 S 0 1 0 0 1
0 D 2 0 2 0 1 0 0 0 3 0 0 0 0
0 3 0 3 0 1 0 0 0 1 0 0 1 0 0
0 D 0 0 0 0 0 0 0 0 0 0 D 0 0
0 0 4 1 0 0 0 0 0 D 1 0 1 0 1
0 0 3 D S 0 1 0 D D 0 0 0 0 0
1 4 0 0 0 3 0 0 1 0 D 1 0 1 0
0 2 0 0 1 0 0 0 0 0 1 D 0 1 0
0 0 0 0 0 0 1 D 1 0 0 0 0 0 D
0 1 1 D 0 0 0 0 0 0 1 1 0 D 0
0 0 0 D 1 0 0 0 1 0 0 0 D 0 0
