15 15 50
D 1 0 0 D 0 0 1 0 0 0 D 3 0 2
1 0 1 0 0 0 0 0 0 1 0 0 D 0 0
0 1 0 0 0 0 0 0 0 0 0 D 0 0 0
0 0 0 D 0 0 1 1 0 1 0 0 0 0 0
D 0 0 0 D 1 0 0 0 1 0 1 0 0 0
0 0 0 0 1 0 1 0 0 0 1 0 0 1 D
0 0 0 1 0 1 0 D 0 D 0 D D 0 0
1 0 0 1 0 0 D 3 3 0 1 0 3 3 4
0 0 0 0 0 0 0 3 0 0 0 0 3 1 D
0 1 0 1 1 0 D 0 0 0 D 1 0 0 2
0 0 0 0 0 1 0 1 0 D D 0 0 0 2
D 0 D 0 1 0 D 0 0 1 0 0 0 0 S
3 D 0 0 0 0 D 3 3 0 0 0 0 D 0
0 0 0 0 0 1 0 3 1 0 0 0 D 5 5
2 0 0 0 0 D 0 4 D 2 2 S 0 5 0
