15 15 50
D 0 0 0 0 0 0 0 0 0 0 0 0 0 0
0 3 0 D 1 0 0 1 0 0 1 3 1 D 1
0 0 D 1 0 0 0 0 2 2 1 1 5 1 1
0 D 1 2 0 2 0 1 S D 0 0 0 3 0
0 1 0 0 2 0 1 1 D 0 0 1 0 D D
0 0 0 2 0 2 0 1 D 0 1 0 0 0 0
0 0 0 0 1 0 0 0 0 0 0 0 0 0 1
0 1 0 1 1 1 0 0 1 0 0 0 0 0 1
0 0 2 S D D 0 1 0 0 0 0 3 0 0
0 0 2 D 0 0 0 0 0 0 0 0 0 2 0
0 1 1 0 0 1 0 0 0 0 0 0 0 0 1
0 3 1 0 1 0 0 0 0 0 0 D 0 0 0
0 1 5 0 0 0 0 0 3 0 0 0 2 1 D
0 D 1 3 D 0 0 0 0 2 0 0 1 D D
0 1 1 0 D 0 1 1 0 0 1 0 D D 3
