15 15 50
1 2 0 0 0 0 0 0 0 0 0 0 2 0 3
2 3 D 0 0 0 0 0 0 0 0 0 0 2 2
0 D 1 1 0 0 D 0 0 0 0 0 0 0 0
0 0 1 0 0 0 0 0 1 0 0 0 0 0 3
0 0 0 0 S 0 0 D 0 0 0 0 0 1 0
0 0 0 0 0 D 3 D 3 3 0 0 0 0 0
0 0 D 0 0 3 D 3 0 3 0 0 0 0 0
0 0 0 0 D D 3 0 3 0 1 0 0 0 0
0 0 0 1 0 3 0 3 0 0 0 1 0 0 0
0 0 0 0 0 3 3 0 0 0 0 0 0 0 0
0 0 0 0 0 0 0 1 0 0 D 0 1 0 0
0 0 0 0 0 0 0 0 1 0 0 S D D 0
2 0 0 0 0 0 0 0 0 0 1 D 0 3 3
0 2 0 0 1 0 0 0 0 0 0 D 3 D 3
3 2 0 3 0 0 0 0 0 0 0 0 3 3 1
