11 11 50
3 D 2 0 0 D 2 1 D 4 4
D 0 0 0 1 0 D S 1 1 4
2 0 D 0 0 1 0 0 0 2 D
0 0 0 D 0 0 0 2 1 1 2
0 1 0 0 0 0 0 0 0 0 D
D 0 1 0 0 0 0 0 1 2 0
2 D 0 0 0 0 0 1 0 3 1
1 S 0 2 0 0 1 D 3 2 0
D 1 0 1 0 1 0 3 D D 3
4 1 2 1 0 2 3 2 D 5 D
4 4 D 2 D 0 1 0 3 D 2
