15 15 50
0 3 2 2 0 1 0 0 0 0 0 0 3 0 0
3 D 3 S 3 0 0 0 1 0 0 0 1 0 0
2 3 0 3 3 0 1 0 0 3 0 0 0 1 0
2 S 3 D D 0 0 0 0 0 0 0 0 0 0
0 3 3 D 0 1 0 0 0 0 0 D 1 1 0
1 0 0 0 1 0 0 0 0 1 0 0 0 0 3
0 0 1 0 0 0 D D 1 0 0 1 0 0 1
0 0 0 0 0 0 D 0 0 0 0 1 1 0 0
0 1 0 0 0 0 1 0 0 0 D D 0 1 0
0 0 3 0 0 1 0 0 0 0 0 3 0 0 0
0 0 0 0 0 0 0 0 D 0 D 0 3 0 0
0 0 0 0 D 0 1 1 D 3 0 0 0 0 0
3 1 0 0 1 0 0 1 0 0 3 0 D 0 0
0 0 1 0 1 0 0 0 1 0 0 0 0 D 1
0 0 0 0 0 3 1 0 0 0 0 0 0 1 0
