7 13 20
1 4 D 0 0 1 0 0 0 D 0 0 0
3 D 0 0 0 S 0 0 D 4 0 D 0
0 0 0 3 0 0 0 0 D 5 5 D 0
0 0 0 3 0 0 0 0 0 5 5 D 2
0 0 0 3 0 0 0 0 D 5 5 D 0
3 D 0 0 0 S 0 0 D 4 0 D 0
1 4 D 0 0 1 0 0 0 D 0 0 0
